NO ./path_to_the_north_texture   
SO ./path_to_the_south_texture
EA ./path_to_the_east_texture
F 200,100,0
C 225,30,0
111111111111111111111111
1000000000110000000000001
1000000001110000000000001
100100000000000000000000111111111
111111111011000001110000000000001
100000000011000001110111111111111
11110111111111011100000010001
11110111111111011101010010001
11000000110101011100000010001
100000000000000 01100000010001
100000000000000 01101010010001
110000011101010 1111011110N01
1111011 11110100 0001111010001
1111111 1111111111111111111111