    



NO ./wall_texture.xpm
WE ./west_wall.xpm
F 250,250,255
C 255,0,0
EA ./east_walls.xpm
SO ./tswiraaaa.xpm

        1111111111111111111111111
        1000000000110000000000001
        1011000001110000000000001
        1001000000000000000000001
111111111011000001110000000000001
100000000011000001111111111111111
1111011111111101110000001N001
11110111111111011101010010001
11000000110101011100000010001
10000000000000001100000010001
10000000000000001101010010001
11000001110101011111010100001
11110111 1110101 101110010001
11111111 1111111 111101111111 